9199900050
9199900049
9199900048
9199900047
9199900046
9199900045
9199900044
9199900043
9199900042
9199900041
9199900040
9199900039
9199900038
9199900037
9199900036
9199900035
9199900034
9199900033
9199900032
9199900031
9199900030
9199900029
9199900028
9199900027
9199900026
9199900025
9199900024
9199900023
9199900022
9199900021
9199900020
9199900019
9199900018
9199900017
9199900016
9199900015
9199900014
9199900013
9199900012
9199900011
9199900010
9199900009
9199900008
9199900007
9199900006
9199900005
9199900004
9199900003
9199900002
9199900001
9199900000
