9999900010
9999900009
9999900008
9999900007
9999900006
9999900005
9999900004
9999900003
9999900002
9999900001
9999900000
